W W W W W W W W W W W W W W W W W W W 
W E S S S S S W E E E W S S S S S E W
W B W W S W W W E E E W W W S W W B W
W S S W S S S W 1 2 3 W S S S W S S W
W S W W S W W W W 0 W W W W S W W S W
W S S S S S S S S S S S S S S S S S W
W W W W S W W W E W E W W W S W W W W
E E E E S W E E E E E E E W S E E E E
W W W W S W E W W S W W E W S W W W W
W S S S S E E W S E E W E E S S S S W
W B W W W W E S S E E E E W W W W B W
W S S S S W E W S E E W E W S S S S W
W W W W S W E W W W W W E W S W W W W
W S S S S S S S S W S S S S S S S S W
W B W W S W W W W W W W W W S W W B W
W S S W S S S S S S S S S S S W S S W
W W S W S W W W W S W W W W S W S W W
W S S S S W S S S S S S S W S S S S W
W S W W W W W S S B S S W W W W W S W
W E S S S S S S S P S S S S S S S E W
W W W W W W W W W W W W W W W W W W W