W W W W W W W W W W W W W W W W W W W 
W E S S S S S W E E E W S S S S S E W
W B W W S W W W E E E W W W S W W B W
E E S W S S S S S S S S S S S W S E E
W S W W S W W W W 0 W W W W S W W S W
W S S S S S S S S S S S S S S S S S W
W W W W S W W W W W W W W W S W W W W
E S S S S W E E E S S S S S S S S E E
W W W W S W W S W W W W W S W W W W W
W S S S S S E S W S S S W S W 1 S S W
W B W W W W W S W S W S W S 0 2 S B W
W S S S S S S S S S W S W S W 3 S S W
W W W W S W E W W W W S W S W W W W W
W S S S S W S S S W S S S S S S S S W
W B W W S W W W W W W W W W S W W B W
W S S W S S S S S P S S S S S W S S W
W W S W S W W W W S W W W W S W S W W
W S S S S W S S W S W S S W S S S S W
W S W W W W W S S B S S W W W W W S W
W E S S S S S S S P S S S S S S S E W
W W W W W W W W W W W W W W W W W W W